And After That We Didn't Talk - Goldlink
Red Album - Tricot
Mellow Dream - Ryo Fukui
Anata Sonata - Wakusei Abnormal
Life Prismic - Reliq
Bucket List Project - Saba
When the Pawn Hits the Conflicts He Thinks - Fiona Apple
Ringo no Uta - Shiina Ringo
No Love Deep Web - Death Grips
pokemonad - Reliq
Man With A Movie Camera - The Cinematic Orchestra
Heaven and Earth - Kamasi Washington
Freeform Jazz - Uyama Hiroto
Tha Carter III - Lil Wayne
Total Loss - How to Dress Well
Is Something Wrong? - Hop Along
Magic Trix - Xenia Rubinos
ART - Benny Sings
Apricot Princess - Rex Orange County
Electric Mole - Shiina Ringo
KOD - J. Cole
Underwater - Elephant Gym
Manchild - Phum Viphurit
You're Dead! - Flying Lotus
To Leave or Die in Long Island - Bomb the Music Industry
Maggot Brain - Funkadelic
Get Warmer - Bomb the Music Industry
Ordinary Songs 3 - Snail's House
Dai Hakken - Tokyo Jihen
Divorce Lawyers I Shaved My Head - Jordaan Mason
ARIZONA BABY - Kevin Abstract
